NO ./includes/textures/night_regular_wall.xpm
EA ./includes/textures/stone_wall.xpm
SO ./includes/textures/wood_wall.xpm
WE ./includes/textures/light_wall.xpm
DO ./includes/textures/wood_door.xpm

F 210,180,140
C 0,0,0

1111
1001
1001
1S01
1001
1001
1001
1001
1001
1001                     111111111
1211                     100000001
1011                     100000001
1011                     100000001
1211                     100000001
1001111111111111111111111100000001
1000000000000000000000000100000001
1000000000000000000000000200000001
1111111111111111111111111111111111