NO /home/brunhenr/cube3D/Cub3D/includes/textures/sky_tina.xpm
SO /home/brunhenr/cube3D/Cub3D/includes/textures/sky_santa.xpm
WE /home/brunhenr/cube3D/Cub3D/includes/textures/sky_stone_sword2.xpm
EA /home/brunhenr/cube3D/Cub3D/includes/textures/sky_stone_sword2.xpm
DO /home/brunhenr/cube3D/Cub3D/includes/textures/door_closed.xpm

F 210,180,140
C 135,206,235

1111
1011
1011
1N11
1012
1011
1011
1011
1011
1011
1211
1011
1011
1111