NO ./includes/textures/moss_wall.xpm
SO ./includes/textures/wood_wall.xpm
WE ./includes/textures/light_wall.xpm
EA ./includes/textures/stone_wall.xpm
DO ./includes/textures/wood_door.xpm


F 210,180,140
C 135,206,235

1111
1011
10011
1N011
10011
10011
10201
10011
10011
10011
121111111111
1011
1011
1111