NO ./includes/textures/light_wall.xpm
SO ./includes/textures/moss_wall.xpm
WE ./includes/textures/stone_wall.xpm
EA ./includes/textures/wood_wall.xpm

F 220,100,0
C 225,30,0

1111111111111111111111111111111111111
1111111111111111111111110000001111111
1111111111111111111111110000001111111
1111111111111111111111110000001111111
1111111111111111111111110000001111111
1111111111111111111111110000001111111
1111111111111111111111110000001111111
1111111111111111111111110000001111111
1111111111111111111111111110111111111
1111111111111111111111111110111111111
1111111111111111111111111000111111111
1111111111111111111111111011111111111
1111111111111111111111111000111111111
111111111111111111111111111011
111111111111111111111111111011
111000000000000000000000000011
1110000000000000000011111111111
1110000000011111111111
111000000001
1110000000011
1110000000011111111111111111111111111
1110000000000000000000000000000000111
1110000000000000000000000000000000111
1110000000000000000000000000000000111
1111111111111111111111111111000000111
1111111111111111111111111111000000111
1110000000000000000000000000000000111
111000N000000000000000000000000000111
1110000000000000000000000000000000111
1111111111111111111111111111111111111