NO ./includes/textures/light_wall.xpm
SO ./includes/textures/moss_wall.xpm
WE ./includes/textures/stone_wall.xpm
EA ./includes/textures/flag_wall.xpm

C 255,00,0
F 00,255,0

111111111111111111111111111111111
100000000000000000110000000000001
100000011110000000110000000000001
1000001    1000001110000000000001
1000001 1111000000000000000000001
111111111011000001110000000000001
100000000011000001110111111111111
11110111111111011100000010001
11110111111111011101010010001
11000000110101011100000010001
10000000000000001100000010001
10000000000000001101010010001
11000001110101011111011110N0111
11110111 1110101 101111010001
11111111 1111111 111111111111
