NO ./includes/textures/light_wall.xpm
SO ./includes/textures/moss_wall.xpm
WE ./includes/textures/stone_wall.xpm
EA ./includes/textures/flag_wall.xpm

C 255,00,0
F 00,255,0

111111111111111111111111111111111
100000000000000000000000000000001
10000000000000000000000N000000001
100000000000111111110000000000001
1000000000001      10000000000001
1000000000001      10000000000001
100000000000111111110000000000001
100000000000000000000000100000001
100000000000000000000000000000011
111111111111111111111111111111111