C 0,0,0
F 0,0,0

NO ./includes/textures/light_wall.xpm
SO ./includes/textures/moss_wall.xpm
WE ./includes/textures/stone_wall.xpm
EA ./includes/textures/flag_wall.xpm
DO ./includes/textures/wood_door.xpm


111111111111111111111111111111111
100000000000000000000000000000001
10000000000000000000000N000000001
100000000000000000000000100000001
100000000000000000000000200000011
100000000000000000000000100000001
111111111111111111111111111111111